{
	"default": 0,
	"map": {
		"HA1": {
			"144": 1,
			"157": 1,
			"159": 1,
			"160": 1,
			"193": 1,
			"222": 1
		}
	}
}
