{
    "default": 0,
    "map": {
        "HA1": {
            "3": 1,
            "45": 1,
            "48": 1,
            "50": 1,
            "75": 1,
            "140": 1,
            "145": 1,
            "156": 1,
            "158": 1,
            "159": 1,
            "173": 1,
            "186": 1,
            "189": 1,
            "193": 1,
            "198": 1,
            "202": 1,
            "212": 1,
            "222": 1,
            "223": 1,
            "225": 1,
            "226": 1,
            "227": 1,
            "278": 1,
            "311": 1,
            "312": 1
        }
    },
    "name": "oracle"
}
